WE ./textures/wood.xpm
SO ./textures/wood.xpm
NO ./textures/redbrick.xpm
EA ./textures/mossy.xpm

F 0,0,155
C 0,0,250

111111111111111111111111
100000000000000000000001
100000000000000000000001
100000000000000000000001
100000000000000000000001                 111
100000000000000000000001                 101
100000000000000000000001                 111
100000000011101000000001
100000000100000100000001
100000000011111000000001
100000000000000000000001
100000000000000000000001
100000000000000000000001
100000000000000010000001
100000000000000000000001
1000000000000000W0000001
110000000000000000000001
100000000000000000000001
100000000000000000000001
100000000000000000000001
100000000000000000000001
100000000000000000000001
100000000000001111111111
11111111111111
111111111111111111111111
11111111111111111111111