
WE ./textures/eagle.xpm

SO ./textures/wood.xpm
NO ./textures/redbrick.xpm
EA ./textures/mossy.xpm

F 220,90,0
C 225,30,0


111111111111111111111111
100000000000000000000001
100000000000000000000001
100000000000000000000001
100000000000000000000001
100000000000000000000001
100000000000000000000001
100000000011111000000001
1000000001     100000001
100000000011111000000001
100000000000000000000001
100000000000000000000001
100000000000000000000001
100000000000000010000001
100000000000000000000001
1000000000000000E0000001
110000000000000000000001
100000000000000000000001
100000000000000000000001
100000000000000000000001
100000000000000000000001
100000000000000000000001
100000000000000011111111
1111111111111111
11111011111111
11111111111111